{
	"numTilesX": 13,
	"numTilesY": 10,
	"size": [64, 64],
	"start": [32, 32],
	"tileNames": ["", "tile01", "tile02", "tile03", "tile04"],
	"tiles": [
			  0, 0, 0, 0, 0, 0, 0, 0, 0, 0, 0, 0, 0,
			  0, 0, 0, 0, 0, 0, 0, 0, 0, 0, 0, 0, 0,
			  0, 0, 0, 0, 0, 0, 0, 0, 0, 0, 0, 0, 0,
			  0, 0, 0, 0, 0, 0, 0, 0, 0, 0, 0, 0, 0,
			  0, 1, 2, 3, 0, 0, 0, 0, 0, 1, 2, 3, 0,
			  0, 0, 0, 0, 0, 0, 0, 0, 0, 0, 0, 0, 0,
			  0, 0, 0, 0, 0, 1, 2, 3, 0, 0, 0, 0, 0,
			  0, 0, 0, 0, 0, 0, 0, 0, 0, 0, 0, 0, 0,
			  2, 2, 2, 2, 2, 2, 2, 2, 2, 2, 2, 2, 2,
			  4, 4, 4, 4, 4, 4, 4, 4, 4, 4, 4, 4, 4
			  ]
}